624387591
139456827
058000400
400010000
000705000
000020008
001000670
300500000
000049210